//MAP CONVERTED BY dmm2tgm.py THIS HEADER COMMENT PREVENTS RECONVERSION, DO NOT REMOVE
"aj" = (
/obj/structure/window/reinforced/survival_pod{
	dir = 1;
	name = "window"
	},
/turf/open/floor/mineral/plastitanium/airless{
	name = "telecomms floor"
	},
/area/ruin/unpowered/syndicate_outpost)
"bA" = (
/obj/structure/table/reinforced,
/obj/item/storage/toolbox/syndicate,
/turf/open/floor/mineral/plastitanium/red{
	name = "base floor"
	},
/area/ruin/unpowered/syndicate_outpost)
"bP" = (
/obj/effect/decal/cleanable/blood/old{
	icon_state = "floor3-old"
	},
/turf/open/floor/plating/asteroid/basalt,
/area/overmap_encounter/planetoid/cave/explored)
"bX" = (
/obj/machinery/smartfridge/survival_pod/empty,
/turf/open/floor/pod/dark,
/area/ruin/powered)
"dc" = (
/obj/mecha/working/ripley/mining{
	ruin_mecha = 1
	},
/turf/open/floor/plating/asteroid/basalt/lava_land_surface,
/area/overmap_encounter/planetoid/cave/explored)
"dN" = (
/obj/structure/sign/mining/survival{
	dir = 4;
	pixel_x = 32
	},
/turf/open/floor/plating/asteroid/basalt/lava_land_surface,
/area/template_noop)
"dO" = (
/mob/living/simple_animal/hostile/asteroid/hivelord/legion/dwarf{
	name = "dwarf bartender"
	},
/turf/open/floor/plating/asteroid/basalt,
/area/overmap_encounter/planetoid/cave/explored)
"ee" = (
/obj/effect/decal/cleanable/blood/drip,
/turf/closed/mineral/volcanic/lava_land_surface,
/area/template_noop)
"ep" = (
/obj/structure/spawner/lavaland/legion,
/turf/open/floor/plating/asteroid/basalt/lava_land_surface,
/area/overmap_encounter/planetoid/lava/explored)
"fi" = (
/turf/closed/mineral/volcanic/lava_land_surface,
/area/template_noop)
"fr" = (
/obj/structure/closet/cabinet,
/obj/item/instrument/banjo,
/obj/item/instrument/trombone,
/turf/open/floor/plating/asteroid/basalt,
/area/overmap_encounter/planetoid/cave/explored)
"fG" = (
/turf/open/floor/mineral/plastitanium/red{
	name = "base floor"
	},
/area/ruin/unpowered/syndicate_outpost)
"fI" = (
/obj/structure/sign/mining/survival{
	dir = 8;
	pixel_x = -32
	},
/turf/open/floor/plating/asteroid/basalt/lava_land_surface,
/area/template_noop)
"fL" = (
/obj/machinery/computer/telecomms/monitor,
/turf/open/floor/mineral/plastitanium/red{
	name = "base floor"
	},
/area/ruin/unpowered/syndicate_outpost)
"fM" = (
/obj/effect/decal/cleanable/blood/footprints,
/obj/effect/decal/cleanable/blood/drip,
/turf/open/floor/plating/asteroid/basalt/lava_land_surface,
/area/template_noop)
"gB" = (
/mob/living/simple_animal/hostile/asteroid/hivelord/legion{
	name = "tall dwarf legion"
	},
/turf/open/floor/plating/asteroid/basalt,
/area/overmap_encounter/planetoid/cave/explored)
"gM" = (
/obj/machinery/door/airlock/hatch{
	dir = 4
	},
/turf/open/floor/mineral/plastitanium/red{
	name = "base floor"
	},
/area/ruin/unpowered/syndicate_outpost)
"hZ" = (
/obj/machinery/telecomms/broadcaster,
/turf/open/floor/mineral/plastitanium/airless{
	name = "telecomms floor"
	},
/area/ruin/unpowered/syndicate_outpost)
"if" = (
/obj/structure/table/wood,
/obj/item/reagent_containers/food/drinks/drinkingglass{
	list_reagents = list(/datum/reagent/consumable/ethanol/fetching_fizz=30)
	},
/turf/open/floor/plating/asteroid/basalt,
/area/overmap_encounter/planetoid/cave/explored)
"iI" = (
/obj/structure/sign/poster/contraband/eat,
/turf/closed/wall/mineral/wood,
/area/overmap_encounter/planetoid/cave/explored)
"iM" = (
/obj/structure/table/wood,
/obj/item/hatchet/wooden,
/obj/item/hatchet/wooden,
/turf/open/floor/plating/asteroid/basalt,
/area/overmap_encounter/planetoid/cave/explored)
"iO" = (
/turf/open/floor/carpet,
/area/ruin/unpowered/syndicate_outpost)
"jt" = (
/obj/effect/decal/cleanable/blood/footprints{
	dir = 8
	},
/obj/effect/decal/cleanable/blood/drip,
/turf/open/floor/plating/asteroid/basalt/lava_land_surface,
/area/template_noop)
"ks" = (
/obj/structure/mineral_door/iron,
/turf/open/floor/plating/asteroid/basalt,
/area/overmap_encounter/planetoid/cave/explored)
"kL" = (
/obj/item/trash/sosjerky{
	pixel_x = -9;
	pixel_y = 16
	},
/turf/open/floor/mineral/plastitanium{
	name = "base floor"
	},
/area/ruin/unpowered/syndicate_outpost)
"kY" = (
/mob/living/simple_animal/hostile/asteroid/hivelord/legion/dwarf{
	name = "dwarf armorer"
	},
/turf/open/floor/plating/asteroid/basalt,
/area/overmap_encounter/planetoid/cave/explored)
"lt" = (
/obj/structure/table/wood,
/obj/item/reagent_containers/food/drinks/drinkingglass{
	list_reagents = list(/datum/reagent/consumable/ethanol/quintuple_sec=20)
	},
/turf/open/floor/plating/asteroid/basalt,
/area/overmap_encounter/planetoid/cave/explored)
"lP" = (
/obj/effect/decal/cleanable/blood/drip,
/obj/effect/decal/cleanable/blood/footprints{
	dir = 1
	},
/turf/open/floor/plating/asteroid/basalt/lava_land_surface,
/area/template_noop)
"mh" = (
/obj/machinery/portable_atmospherics/canister/air,
/turf/open/floor/mineral/plastitanium/red{
	name = "base floor"
	},
/area/ruin/unpowered/syndicate_outpost)
"mN" = (
/obj/structure/chair/stool/bar,
/mob/living/simple_animal/hostile/asteroid/hivelord/legion{
	icon_aggro = "dwarf_legion";
	icon_dead = "dwarf_legion";
	icon_living = "dwarf_legion";
	icon_state = "dwarf_legion";
	name = "dwarf legion"
	},
/turf/open/floor/plating/asteroid/basalt,
/area/overmap_encounter/planetoid/cave/explored)
"mO" = (
/obj/item/chair/wood/wings,
/turf/open/floor/plating/asteroid/basalt,
/area/overmap_encounter/planetoid/cave/explored)
"nY" = (
/obj/effect/decal/cleanable/blood,
/mob/living/simple_animal/hostile/asteroid/goliath/beast{
	health = 0
	},
/turf/open/floor/plating/asteroid/basalt/lava_land_surface,
/area/template_noop)
"ov" = (
/turf/open/floor/plating/asteroid/basalt/lava_land_surface,
/area/overmap_encounter/planetoid/cave/explored)
"pc" = (
/obj/structure/table/reinforced,
/obj/item/paper/crumpled/awaymissions/moonoutpost19/hastey_note{
	desc = "It seems like it was written in a hurry";
	default_raw_text = "<i>Hey, you're probably reading this after having killed me, but that's alright. I probably shot first. Names' Yuto, Syndicate Radio Operator, there used to be another op here, a nice one too. Had syndicate command not forgotten about this post, we'd of probably been executed for sentinmental attachments on the job. Although she didn't have to worry about that, the local fauna got her first. I guess this note is my way of saying sorry. Take what you want from this station and my body, you need it more than I do now. Good luck out there, whoever you are. - Syndicate Radio</i><br><br><i>e f.</i>";
	pixel_x = -3;
	pixel_y = 2
	},
/obj/item/candle{
	pixel_x = 8;
	pixel_y = 5
	},
/turf/open/floor/carpet,
/area/ruin/unpowered/syndicate_outpost)
"pQ" = (
/turf/closed/wall/mineral/titanium/survival/pod,
/area/ruin/powered)
"pT" = (
/obj/machinery/telecomms/bus,
/turf/open/floor/mineral/plastitanium/airless{
	name = "telecomms floor"
	},
/area/ruin/unpowered/syndicate_outpost)
"qj" = (
/mob/living/simple_animal/hostile/asteroid/hivelord/legion/dwarf,
/obj/effect/decal/cleanable/blood/old,
/turf/open/floor/plating/asteroid/basalt,
/area/overmap_encounter/planetoid/cave/explored)
"qN" = (
/turf/open/floor/mineral/plastitanium{
	name = "base floor"
	},
/area/ruin/unpowered/syndicate_outpost)
"rn" = (
/obj/machinery/computer/telecomms{
	dir = 8
	},
/turf/open/floor/mineral/plastitanium/red{
	name = "base floor"
	},
/area/ruin/unpowered/syndicate_outpost)
"rq" = (
/obj/machinery/door/window,
/turf/open/floor/mineral/plastitanium/red{
	name = "base floor"
	},
/area/ruin/unpowered/syndicate_outpost)
"rv" = (
/obj/structure/sign/mining/survival{
	pixel_y = 32
	},
/turf/open/floor/plating/asteroid/basalt/lava_land_surface,
/area/overmap_encounter/planetoid/lava/explored)
"sr" = (
/mob/living/simple_animal/hostile/big_legion,
/turf/open/floor/plating/asteroid/basalt/lava_land_surface,
/area/template_noop)
"sz" = (
/obj/structure/spawner/lavaland/legion,
/turf/open/floor/plating/asteroid/basalt,
/area/overmap_encounter/planetoid/cave/explored)
"sF" = (
/obj/structure/table/reinforced,
/obj/item/flashlight/lantern/lanternbang,
/turf/open/floor/mineral/plastitanium/red{
	name = "base floor"
	},
/area/ruin/unpowered/syndicate_outpost)
"sR" = (
/obj/structure/fermenting_barrel,
/turf/open/floor/plating/asteroid/basalt,
/area/overmap_encounter/planetoid/cave/explored)
"sS" = (
/turf/template_noop,
/area/template_noop)
"sU" = (
/obj/item/soulstone,
/obj/structure/closet/crate/grave/loot,
/turf/open/floor/plating/asteroid/basalt/lava_land_surface,
/area/template_noop)
"th" = (
/obj/structure/table/wood,
/obj/item/reagent_containers/food/drinks/drinkingglass{
	list_reagents = list(/datum/reagent/consumable/ethanol/turbo=20)
	},
/turf/open/floor/plating/asteroid/basalt,
/area/overmap_encounter/planetoid/cave/explored)
"tn" = (
/obj/machinery/vending/cigarette/syndicate,
/turf/open/floor/carpet/black,
/area/ruin/unpowered/syndicate_outpost)
"uf" = (
/obj/effect/decal/cleanable/blood/footprints{
	dir = 1
	},
/obj/machinery/door/airlock/survival_pod/glass,
/turf/open/floor/pod/dark,
/area/ruin/powered)
"ui" = (
/obj/effect/decal/cleanable/blood/old{
	icon_state = "floor4-old"
	},
/turf/open/floor/plating/asteroid/basalt,
/area/overmap_encounter/planetoid/cave/explored)
"uU" = (
/obj/machinery/sleeper/survival_pod,
/turf/open/floor/pod/dark,
/area/ruin/powered)
"uW" = (
/obj/effect/decal/cleanable/blood/old{
	icon_state = "floor2-old"
	},
/turf/open/floor/plating/asteroid/basalt,
/area/overmap_encounter/planetoid/cave/explored)
"uX" = (
/turf/open/floor/plating/asteroid/basalt/lava_land_surface,
/area/template_noop)
"vu" = (
/obj/effect/spawner/structure/window/plasma/reinforced/plastitanium,
/turf/open/floor/plating,
/area/ruin/unpowered/syndicate_outpost)
"vX" = (
/obj/structure/sign/mining{
	pixel_y = 32
	},
/obj/effect/decal/cleanable/blood/footprints{
	dir = 8
	},
/turf/open/floor/plating/asteroid/basalt/lava_land_surface,
/area/template_noop)
"wm" = (
/obj/structure/bed,
/obj/item/bedsheet/dorms,
/turf/open/floor/plating/asteroid/basalt,
/area/overmap_encounter/planetoid/cave/explored)
"xi" = (
/turf/closed/mineral/volcanic/lava_land_surface,
/area/overmap_encounter/planetoid/cave/explored)
"xP" = (
/obj/structure/chair/wood/wings{
	dir = 1
	},
/mob/living/simple_animal/hostile/asteroid/hivelord/legion{
	icon_aggro = "dwarf_legion";
	icon_dead = "dwarf_legion";
	icon_living = "dwarf_legion";
	icon_state = "dwarf_legion";
	name = "dwarf legion"
	},
/turf/open/floor/plating/asteroid/basalt,
/area/overmap_encounter/planetoid/cave/explored)
"xR" = (
/turf/closed/wall/mineral/wood,
/area/overmap_encounter/planetoid/cave/explored)
"yc" = (
/obj/item/clothing/suit/armor/riot/knight,
/obj/item/clothing/head/helmet/knight/blue,
/obj/item/claymore,
/turf/open/floor/plating/asteroid/basalt/lava_land_surface,
/area/template_noop)
"yZ" = (
/obj/structure/table/reinforced,
/turf/open/floor/mineral/plastitanium/red{
	name = "base floor"
	},
/area/ruin/unpowered/syndicate_outpost)
"zJ" = (
/obj/structure/fans,
/turf/open/floor/pod/dark,
/area/ruin/powered)
"zP" = (
/obj/effect/mob_spawn/human/miner{
	brute_damage = 150;
	oxy_damage = 50
	},
/obj/effect/decal/cleanable/blood,
/obj/effect/decal/cleanable/blood/drip,
/obj/effect/decal/cleanable/blood/footprints{
	dir = 1
	},
/turf/open/floor/pod/dark,
/area/ruin/powered)
"zY" = (
/mob/living/simple_animal/hostile/asteroid/hivelord/legion{
	icon_aggro = "dwarf_legion";
	icon_dead = "dwarf_legion";
	icon_living = "dwarf_legion";
	icon_state = "dwarf_legion";
	name = "dwarf legion"
	},
/turf/open/floor/plating/asteroid/basalt,
/area/overmap_encounter/planetoid/cave/explored)
"Ay" = (
/turf/open/floor/plating/asteroid/basalt,
/area/overmap_encounter/planetoid/cave/explored)
"Bd" = (
/obj/effect/decal/cleanable/blood/old{
	icon_state = "floor6-old"
	},
/turf/open/floor/plating/asteroid/basalt,
/area/overmap_encounter/planetoid/cave/explored)
"BB" = (
/turf/closed/wall/mineral/plastitanium/interior,
/area/ruin/unpowered/syndicate_outpost)
"Cf" = (
/obj/structure/table/wood,
/obj/item/fireaxe/boneaxe,
/turf/open/floor/plating/asteroid/basalt,
/area/overmap_encounter/planetoid/cave/explored)
"CI" = (
/obj/structure/table/wood,
/obj/item/toy/plush/lizardplushie{
	pixel_y = 3
	},
/turf/open/floor/plating/asteroid/basalt,
/area/overmap_encounter/planetoid/cave/explored)
"Dk" = (
/obj/structure/bed,
/turf/open/floor/plating/asteroid/basalt,
/area/overmap_encounter/planetoid/cave/explored)
"Dp" = (
/obj/structure/filingcabinet,
/turf/open/floor/mineral/plastitanium/red{
	name = "base floor"
	},
/area/ruin/unpowered/syndicate_outpost)
"En" = (
/obj/machinery/door/airlock/highsecurity{
	hackProof = 1;
	name = "Secure Airlock"
	},
/turf/open/floor/mineral/plastitanium{
	name = "base floor"
	},
/area/ruin/unpowered/syndicate_outpost)
"ET" = (
/obj/structure/table/wood,
/obj/item/reagent_containers/food/drinks/drinkingglass{
	list_reagents = list(/datum/reagent/consumable/ethanol/hearty_punch=25)
	},
/turf/open/floor/plating/asteroid/basalt,
/area/overmap_encounter/planetoid/cave/explored)
"Fg" = (
/obj/effect/decal/cleanable/blood/drip{
	pixel_x = 13;
	pixel_y = 8
	},
/turf/open/floor/plating/asteroid/basalt/lava_land_surface,
/area/overmap_encounter/planetoid/lava/explored)
"Fs" = (
/obj/structure/table/wood,
/obj/item/spear/bonespear,
/turf/open/floor/plating/asteroid/basalt,
/area/overmap_encounter/planetoid/cave/explored)
"FI" = (
/obj/structure/table/survival_pod,
/obj/item/kitchen/knife/combat/survival,
/turf/open/floor/pod/dark,
/area/ruin/powered)
"FU" = (
/obj/machinery/light/dim/directional/south,
/turf/open/floor/mineral/plastitanium{
	name = "base floor"
	},
/area/ruin/unpowered/syndicate_outpost)
"GD" = (
/obj/structure/table/wood,
/obj/item/reagent_containers/food/snacks/meat/steak/goliath{
	pixel_y = 6
	},
/turf/open/floor/plating/asteroid/basalt,
/area/overmap_encounter/planetoid/cave/explored)
"GL" = (
/mob/living/simple_animal/hostile/asteroid/hivelord/legion/dwarf,
/turf/open/floor/plating/asteroid/basalt,
/area/overmap_encounter/planetoid/cave/explored)
"GR" = (
/obj/effect/decal/cleanable/blood/drip,
/turf/open/floor/plating/asteroid/basalt/lava_land_surface,
/area/template_noop)
"GS" = (
/obj/item/dice/d20{
	pixel_x = 5;
	pixel_y = 6
	},
/obj/item/toy/figure/clown{
	pixel_x = -7;
	pixel_y = 1
	},
/obj/structure/table/wood/fancy/purple,
/turf/open/floor/plating/asteroid/basalt,
/area/overmap_encounter/planetoid/cave/explored)
"Hg" = (
/obj/structure/table/wood,
/obj/item/reagent_containers/food/drinks/drinkingglass{
	list_reagents = list(/datum/reagent/consumable/ethanol/manly_dorf=30)
	},
/turf/open/floor/plating/asteroid/basalt,
/area/overmap_encounter/planetoid/cave/explored)
"Hj" = (
/obj/structure/chair/wood/wings{
	dir = 8
	},
/turf/open/floor/plating/asteroid/basalt,
/area/overmap_encounter/planetoid/cave/explored)
"HE" = (
/obj/item/clothing/shoes/workboots/mining,
/obj/item/clothing/under/rank/cargo/miner/lavaland,
/obj/effect/decal/remains/human,
/turf/open/floor/plating/asteroid/basalt/lava_land_surface,
/area/overmap_encounter/planetoid/cave/explored)
"HZ" = (
/obj/structure/table/wood,
/obj/item/flashlight/lantern,
/obj/item/flashlight/lantern,
/obj/item/flashlight/lantern,
/turf/open/floor/plating/asteroid/basalt,
/area/overmap_encounter/planetoid/cave/explored)
"IO" = (
/obj/structure/closet/crate/grave/loot,
/turf/open/floor/plating/asteroid/basalt/lava_land_surface,
/area/overmap_encounter/planetoid/lava/explored)
"Js" = (
/obj/structure/chair/comfy/grey/directional/north{
	desc = "It looks like it hasn't been used in a long time."
	},
/turf/open/floor/carpet/black,
/area/ruin/unpowered/syndicate_outpost)
"Kq" = (
/obj/effect/decal/cleanable/blood/footprints{
	dir = 8
	},
/turf/open/floor/plating/asteroid/basalt/lava_land_surface,
/area/template_noop)
"Le" = (
/obj/structure/window/reinforced/survival_pod{
	dir = 1;
	name = "Window"
	},
/turf/open/floor/mineral/plastitanium/airless{
	name = "telecomms floor"
	},
/area/ruin/unpowered/syndicate_outpost)
"Lq" = (
/obj/structure/bed/pod,
/obj/item/bedsheet/black,
/obj/structure/tubes,
/obj/machinery/light/small/directional/east,
/turf/open/floor/pod/dark,
/area/ruin/powered)
"Lt" = (
/obj/structure/constructshell,
/obj/item/clothing/head/helmet/chaplain/witchunter_hat,
/obj/item/clothing/suit/armor/riot/chaplain/witchhunter,
/obj/item/clothing/glasses/welding/ghostbuster,
/turf/open/floor/plating/asteroid/basalt/lava_land_surface,
/area/template_noop)
"MR" = (
/obj/structure/barricade/wooden,
/turf/open/floor/plating/asteroid/basalt,
/area/overmap_encounter/planetoid/cave/explored)
"MT" = (
/obj/structure/bed/dogbed{
	desc = "A well worn dog bed, wait... are dog beds supposed to have burn marks?."
	},
/mob/living/simple_animal/hostile/asteroid/basilisk/watcher/magmawing{
	desc = "A domesticated Magmawing watcher, you weren't aware that was even possible. Unfortunately though, it's been domesticated by the Syndicate..";
	dir = 4;
	faction = list("Syndicate");
	movement_type = 1
	},
/turf/open/floor/mineral/plastitanium{
	name = "base floor"
	},
/area/ruin/unpowered/syndicate_outpost)
"MZ" = (
/obj/machinery/light/dim/directional/north,
/turf/open/floor/carpet,
/area/ruin/unpowered/syndicate_outpost)
"Nz" = (
/turf/closed/wall/mineral/plastitanium,
/area/ruin/unpowered/syndicate_outpost)
"NL" = (
/obj/structure/table/wood,
/obj/item/toy/cards/deck{
	pixel_y = 5
	},
/turf/open/floor/plating/asteroid/basalt,
/area/overmap_encounter/planetoid/cave/explored)
"NQ" = (
/obj/structure/table/reinforced,
/obj/item/radio/intercom/wideband/directional/north,
/turf/open/floor/mineral/plastitanium/red{
	name = "base floor"
	},
/area/ruin/unpowered/syndicate_outpost)
"Oy" = (
/obj/structure/chair/comfy/orange/directional/south,
/turf/open/floor/plating/asteroid/basalt,
/area/overmap_encounter/planetoid/cave/explored)
"OP" = (
/obj/structure/chair/comfy/grey/directional/south,
/turf/open/floor/carpet,
/area/ruin/unpowered/syndicate_outpost)
"Pl" = (
/obj/effect/decal/cleanable/blood/gibs/old,
/obj/item/clothing/head/helmet/skull,
/turf/open/floor/plating/asteroid/basalt,
/area/overmap_encounter/planetoid/cave/explored)
"PB" = (
/obj/structure/table/wood,
/obj/item/shield/riot/buckler,
/obj/item/shield/riot/buckler,
/turf/open/floor/plating/asteroid/basalt,
/area/overmap_encounter/planetoid/cave/explored)
"PT" = (
/turf/open/floor/carpet/black,
/area/ruin/unpowered/syndicate_outpost)
"PW" = (
/obj/effect/decal/cleanable/blood/old,
/obj/item/flashlight/flare/torch,
/turf/open/floor/plating/asteroid/basalt,
/area/overmap_encounter/planetoid/cave/explored)
"QZ" = (
/obj/structure/table/wood,
/obj/item/pickaxe,
/obj/item/pickaxe,
/turf/open/floor/plating/asteroid/basalt,
/area/overmap_encounter/planetoid/cave/explored)
"RH" = (
/obj/machinery/light/dim/directional/west,
/obj/effect/decal/cleanable/blood,
/turf/open/floor/mineral/plastitanium/red{
	name = "base floor"
	},
/area/ruin/unpowered/syndicate_outpost)
"RP" = (
/obj/structure/reagent_dispensers/beerkeg,
/turf/open/floor/plating/asteroid/basalt,
/area/overmap_encounter/planetoid/cave/explored)
"RY" = (
/obj/machinery/door/window/survival_pod{
	dir = 1
	},
/turf/open/floor/mineral/plastitanium/airless{
	name = "telecomms floor"
	},
/area/ruin/unpowered/syndicate_outpost)
"Sv" = (
/obj/structure/sign/poster/official/high_class_martini,
/turf/closed/wall/mineral/wood,
/area/overmap_encounter/planetoid/cave/explored)
"Tb" = (
/obj/machinery/door/airlock/hatch,
/turf/open/floor/mineral/plastitanium{
	name = "base floor"
	},
/area/ruin/unpowered/syndicate_outpost)
"Ti" = (
/obj/structure/table/wood,
/obj/item/reagent_containers/food/drinks/ale{
	pixel_x = -6;
	pixel_y = 2
	},
/obj/item/reagent_containers/food/drinks/bottle/lizardwine{
	pixel_x = 7;
	pixel_y = 5
	},
/turf/open/floor/plating/asteroid/basalt,
/area/overmap_encounter/planetoid/cave/explored)
"Tj" = (
/obj/item/gps/computer,
/obj/structure/tubes,
/turf/open/floor/pod/dark,
/area/ruin/powered)
"Uq" = (
/obj/structure/closet/crate,
/obj/item/clothing/gloves/combat,
/obj/item/gun/ballistic/automatic/pistol,
/obj/item/ammo_box/magazine/m10mm,
/obj/item/ammo_box/magazine/m10mm,
/obj/item/ammo_box/magazine/m10mm,
/turf/open/floor/carpet/black,
/area/ruin/unpowered/syndicate_outpost)
"UM" = (
/obj/structure/table/wood,
/obj/item/gun/energy/kinetic_accelerator/old,
/turf/open/floor/plating/asteroid/basalt,
/area/overmap_encounter/planetoid/cave/explored)
"UV" = (
/obj/machinery/telecomms/receiver,
/turf/open/floor/mineral/plastitanium/airless{
	name = "telecomms floor"
	},
/area/ruin/unpowered/syndicate_outpost)
"Vk" = (
/obj/structure/chair/stool/bar,
/turf/open/floor/plating/asteroid/basalt,
/area/overmap_encounter/planetoid/cave/explored)
"VG" = (
/obj/structure/tubes,
/obj/item/crowbar,
/obj/effect/decal/cleanable/blood/drip,
/turf/open/floor/pod/dark,
/area/ruin/powered)
"VR" = (
/obj/structure/chair/comfy/grey/directional/west,
/turf/open/floor/mineral/plastitanium/red{
	name = "base floor"
	},
/area/ruin/unpowered/syndicate_outpost)
"VX" = (
/obj/structure/table/reinforced,
/obj/item/trash/syndi_cakes{
	pixel_y = 13
	},
/turf/open/floor/mineral/plastitanium/red{
	name = "base floor"
	},
/area/ruin/unpowered/syndicate_outpost)
"Wz" = (
/obj/structure/spawner/lavaland/legion,
/turf/open/lava/smooth/lava_land_surface,
/area/overmap_encounter/planetoid/lava/explored)
"WD" = (
/turf/open/lava/smooth/lava_land_surface,
/area/overmap_encounter/planetoid/lava/explored)
"XR" = (
/mob/living/simple_animal/hostile/asteroid/hivelord/legion/dwarf,
/turf/open/floor/mineral/plastitanium{
	name = "base floor"
	},
/area/ruin/unpowered/syndicate_outpost)
"XW" = (
/obj/effect/decal/cleanable/blood/old{
	icon_state = "floor7-old"
	},
/turf/open/floor/plating/asteroid/basalt,
/area/overmap_encounter/planetoid/cave/explored)
"YP" = (
/turf/open/floor/plating/asteroid/basalt/lava_land_surface,
/area/overmap_encounter/planetoid/lava/explored)
"Zc" = (
/obj/effect/decal/cleanable/blood/old{
	icon_state = "floor5-old"
	},
/turf/open/floor/plating/asteroid/basalt,
/area/overmap_encounter/planetoid/cave/explored)
"Zj" = (
/obj/machinery/vending/sustenance,
/turf/open/floor/carpet/black,
/area/ruin/unpowered/syndicate_outpost)
"Zn" = (
/obj/machinery/light/dim/directional/west,
/turf/open/floor/mineral/plastitanium{
	name = "base floor"
	},
/area/ruin/unpowered/syndicate_outpost)
"Zt" = (
/obj/item/pickaxe,
/obj/effect/decal/cleanable/blood,
/turf/open/floor/pod/dark,
/area/ruin/powered)
"ZT" = (
/obj/effect/decal/cleanable/blood,
/turf/open/floor/plating/asteroid/basalt/lava_land_surface,
/area/template_noop)

(1,1,1) = {"
uX
uX
uX
uX
uX
uX
uX
uX
xi
xi
xi
xi
xi
xi
xi
xi
xi
xi
xi
xi
xi
xi
xi
xi
xi
xi
"}
(2,1,1) = {"
uX
dN
uX
dN
uX
YP
YP
YP
xi
xi
xi
xR
xR
xR
xR
xR
xR
xR
xR
xR
xR
xi
xi
xi
xi
xi
"}
(3,1,1) = {"
pQ
pQ
pQ
pQ
pQ
YP
ep
YP
xi
xi
xR
iI
RP
Ay
GS
xP
xR
Dk
zY
wm
xR
uW
Ay
Ay
xi
xi
"}
(4,1,1) = {"
pQ
zJ
uU
FI
pQ
rv
YP
YP
xi
xi
xR
Ay
Ay
Ay
Hj
Ay
xR
wm
Ay
Dk
xR
Ay
sz
Ay
Ay
xi
"}
(5,1,1) = {"
pQ
bX
Zt
zP
uf
lP
uX
uX
xi
xi
xR
Ay
ET
Vk
Ay
Ay
xR
Dk
XW
Dk
xR
Ay
Ay
Zc
Ay
xi
"}
(6,1,1) = {"
pQ
Tj
Lq
VG
pQ
vX
uX
uX
xi
xi
xR
Ay
lt
Vk
Ay
Ay
xR
Dk
Ay
wm
xR
ui
Ay
Ay
xi
xi
"}
(7,1,1) = {"
pQ
pQ
pQ
pQ
pQ
Kq
GR
ee
xi
xi
xR
dO
Hg
mN
Ay
Ay
ks
Ay
Ay
Dk
xR
Ay
MR
xi
xi
xi
"}
(8,1,1) = {"
uX
fI
uX
fI
jt
fM
fi
fi
xi
xi
xR
Ay
NL
Vk
Ay
Ay
xR
uW
Ay
qj
xR
Ay
Ay
bP
xi
xi
"}
(9,1,1) = {"
uX
GR
ZT
uX
xi
xi
xi
fi
xi
xi
xR
Ti
GD
Vk
Ay
Ay
xR
Dk
Ay
wm
xR
Ay
Pl
Ay
xi
xi
"}
(10,1,1) = {"
sS
uX
nY
xi
ov
xi
ov
xi
xi
xi
xR
sR
Ay
Ay
Ay
fr
xR
wm
zY
Ay
xR
xi
MR
GL
xi
xi
"}
(11,1,1) = {"
sS
uX
uX
xi
ov
dc
HE
xi
xi
xi
xR
xR
xR
xR
Ay
Sv
xR
xR
xR
ks
xR
xR
Ay
Ay
xi
xi
"}
(12,1,1) = {"
sS
uX
uX
xi
ov
ov
xi
xi
xi
xi
xi
xR
mO
Ay
Ay
Ay
Ay
xR
Ay
Ay
UM
xR
Ay
Bd
xi
xi
"}
(13,1,1) = {"
sS
uX
uX
xi
xi
xi
xi
fi
fi
xi
xi
xR
if
Ay
Ay
gB
th
xR
QZ
Ay
Ay
xR
Ay
Ay
xi
xi
"}
(14,1,1) = {"
sS
uX
uX
uX
uX
uX
uX
fi
fi
xi
xi
xR
Hj
Ay
Ay
Ay
Ay
xR
Cf
Ay
ui
ks
Ay
Ay
xi
xi
"}
(15,1,1) = {"
fi
uX
uX
uX
uX
uX
uX
uX
uX
xi
xR
xR
Ay
GL
Ay
Ay
Ay
xR
HZ
kY
Ay
ks
uW
Ay
xi
xi
"}
(16,1,1) = {"
fi
fi
uX
uX
uX
uX
uX
uX
uX
PW
xR
Ay
Ay
Ay
Ay
CI
Ay
xR
Ay
XW
Ay
xR
Ay
Ay
xi
xi
"}
(17,1,1) = {"
fi
fi
fi
fi
uX
uX
sr
uX
uX
Ay
ks
Ay
Ay
Ay
Ay
Oy
Ay
xR
iM
Fs
PB
xR
Ay
Ay
xi
xi
"}
(18,1,1) = {"
fi
fi
fi
fi
fi
fi
uX
uX
uX
zY
xR
xR
xR
xR
xR
xR
xR
xR
xR
xR
xR
xR
zY
xi
xi
xi
"}
(19,1,1) = {"
fi
fi
fi
fi
fi
uX
uX
uX
uX
xi
xi
xi
xi
xi
xi
xi
xi
xi
xi
xi
xi
xi
xi
xi
xi
xi
"}
(20,1,1) = {"
fi
fi
fi
fi
uX
YP
YP
YP
uX
xi
xi
xi
xi
xi
xi
xi
xi
xi
xi
xi
xi
xi
xi
xi
xi
xi
"}
(21,1,1) = {"
sS
fi
fi
fi
uX
YP
ep
YP
uX
uX
uX
uX
WD
WD
WD
WD
WD
WD
WD
WD
WD
sS
sS
sS
sS
sS
"}
(22,1,1) = {"
sS
sS
fi
fi
uX
YP
YP
YP
uX
uX
uX
WD
WD
YP
YP
YP
YP
YP
YP
YP
Wz
WD
sS
sS
sS
sS
"}
(23,1,1) = {"
sS
sS
sS
fi
fi
fi
uX
uX
uX
uX
WD
WD
YP
YP
YP
YP
YP
YP
YP
YP
YP
WD
WD
WD
WD
sS
"}
(24,1,1) = {"
sS
sS
sS
fi
fi
fi
fi
fi
uX
uX
WD
YP
Nz
Nz
Nz
En
Nz
Nz
YP
YP
YP
YP
YP
YP
WD
WD
"}
(25,1,1) = {"
sS
sS
sS
fi
fi
fi
fi
uX
uX
uX
WD
YP
Nz
MT
Zn
XR
qN
Nz
Nz
YP
YP
YP
YP
YP
YP
WD
"}
(26,1,1) = {"
sS
sS
fi
fi
fi
fi
uX
uX
uX
uX
WD
YP
vu
qN
kL
qN
qN
qN
Nz
Nz
Nz
Nz
Nz
YP
YP
WD
"}
(27,1,1) = {"
sS
fi
fi
fi
fi
fi
uX
uX
uX
uX
WD
YP
vu
VX
NQ
yZ
yZ
qN
qN
BB
tn
Zj
Nz
Nz
YP
WD
"}
(28,1,1) = {"
fi
fi
fi
fi
fi
fi
uX
uX
uX
uX
WD
YP
vu
fG
VR
fG
sF
qN
qN
Tb
iO
PT
Uq
Nz
YP
WD
"}
(29,1,1) = {"
fi
fi
uX
Lt
fi
fi
uX
uX
uX
fi
WD
YP
Nz
Dp
fG
fG
rq
XR
FU
BB
MZ
iO
PT
Nz
YP
WD
"}
(30,1,1) = {"
fi
sU
uX
uX
fi
uX
uX
uX
uX
fi
WD
YP
Nz
BB
BB
gM
BB
BB
BB
BB
OP
pc
Js
Nz
YP
WD
"}
(31,1,1) = {"
fi
uX
yc
uX
fi
uX
uX
uX
fi
fi
WD
Fg
Nz
fL
RH
fG
fG
aj
hZ
BB
vu
vu
vu
Nz
YP
WD
"}
(32,1,1) = {"
fi
fi
fi
uX
fi
uX
uX
fi
fi
fi
WD
WD
Nz
Nz
rn
fG
fG
RY
pT
Nz
YP
YP
YP
YP
YP
WD
"}
(33,1,1) = {"
sS
fi
fi
uX
uX
uX
fi
fi
fi
fi
uX
WD
YP
Nz
Nz
bA
mh
Le
UV
Nz
IO
YP
YP
YP
WD
WD
"}
(34,1,1) = {"
sS
fi
fi
fi
fi
fi
fi
fi
fi
fi
uX
WD
YP
YP
Nz
Nz
Nz
Nz
Nz
Nz
WD
WD
WD
WD
WD
sS
"}
(35,1,1) = {"
sS
sS
fi
fi
fi
fi
fi
fi
fi
fi
uX
WD
WD
YP
YP
WD
WD
WD
WD
WD
WD
WD
WD
WD
sS
sS
"}
(36,1,1) = {"
sS
sS
sS
fi
fi
fi
fi
fi
fi
fi
uX
uX
WD
WD
WD
WD
sS
sS
sS
sS
sS
sS
sS
sS
sS
sS
"}
